11111111111111111111111
10P000000C0000C00000E01
10111110101000101111101
10100000101101101000101
10111110101010101000101
1C000010101000101000101
10111110101000101111101
1000M0000000M0000000001
11111111111111111111111
