11111111111111111111111
10P00C0000C000000000E01
10111110101000101111101
101000001011011010001C1
10111110101010101000101
10000010101000101000101
10111110101000101111101
10000000000000000000001
11111111111111111111111
